%%%%%%%%%%%%%%%%%%%%%%%%%%%%%%%%%%%%%
%   %   % % %   % %   % %         % %
%% % % %% % % % %  % %   % %% % %   %
% %           %   %   % %         % %
%% % %% %% % % % %  %    % % % %% %%%
%       %   %     % % % % %     %   %
% % % %% %% % % % % %% %  % % %%  % %
% %   %     % %         %     % %   %
%  % %% % %  % % %%%% %   %% %  %% %%
% % %       % %         %     %     %
%% % %% % % % % % %% %%% % % % % %% %
% %   % %         %         %   %   %
% % %    % % % %%  % %% %% %% %   % %
%     % %       % %             % % %
% % %% % %% % %   % %% % % % % %%%% %
%   %   % % % % %   % % %           %
% %  %%  %%       %    % % %%% %%% %%
%   %   %   % % %   % %   %         %
% %  % % %%   % % %%% % %% % % %% % %
% % %       % %   %     %     % % % %
% %% % % % %%  %%  %% % %% % % %    %
% %       % % %   %   %         % % %
%%  % %%%    %%% %% %  %%% %%% %%   %
% %       % %   % %   %           % %
% % % % %% %% % %   % % %% % % %% %%%
%   %         %   % %   %       %   %
%%%  % % %% %   % % % %%  % % %   %%%
% % % %       %   %   % % %     %   %
%%     %%% % %  %   %   %   %% % % %%
% % % %       %   %   %   %         %
% %  %  % %% %  % % %%%%% % % %% %%%%
%   % %   %   %   %   % %   %     % %
%% % %  %  % %  %   %     % % % %   %
%   % %   %   %   % % % %   %     % %
%%%    % % %% %% %  % %%% %   % %   %
%.  % % %     %   %       % %   % %P%
%%%%%%%%%%%%%%%%%%%%%%%%%%%%%%%%%%%%%
