%%%%%%%%%%%%%%%%%%%%%%
% %%        % %      %
%    % %%%% % %%%%%% %
%%% %%     P  %      %
%    %%%%%%%%%%% %%%%%
% %%%            %   %
%     %%%%% % % % % %%
%%%%%%%%             %
%.       % % % % % % %
%%%%%%%%%%%%%%%%%%%%%%
