%%%%%%%%%%%%%%%%%%%%%%
% %%        % %      %
%    %%%%%% % %%%%%% %
%%%%%%     P  %      %
%    % %%%%%% %% %%%%%
% %%%% %         %   %
%        %%   %%   % %
%%%%%%%%%%%% %%%%%%%%%
%.                   %
%%%%%%%%%%%%%%%%%%%%%%
