%%%%%%%%%%%%%%%%%%%%
%.                 %
%P               . %
%.                 %
%%%%%%%%%%%%%%%%%%%%