%%%%%%%%%%%%%%%%%%%%%%%
%  .   P       %     .%
% %%%%%%% %%%%%% %  % %
%    %         % %  % %
%                %    %
%%%%%%%%%%%%%%  %%%%%%%
%                     %
%                     %
%%%%%%%%%%%%%%%%%%%%%%%
