%%%%%%%%%%%%%%%%%%%%%%%
%  .   P       %     .%
% %%%%%%% %%%%%% %  % %
%    %         % %  % %
%    .           %    %
%%%%%%%%%%%%%%  %%%%%%%
%                     %
%              .      %
%%%%%%%%%%%%%%%%%%%%%%%
